0000000000000000000
0111111111111111110
0100100000000010010
0111111111111111110
0100101000001010010
0111101110111010010
0100100010100010010
0100101111111010010
0100101001001010010
0111111111111111110
0100100000000010010
0111111111111111110
0100101000001010010
0111101110111010010
0100100010100010010
0100101111111010010
0100101001001010010
0111111111111111110